WWWWWWWWWWWWWWWWWWWW
WGGGGGGGGGGGGGGGGGGW
WGGG*GGGGGGGGGGGGGGW
WGGGGGGGGGGGGGGGGGGW
WGGGGGGGGGGGGGGGGGGW
WGGHGGGGGGGGGGGGGGGW
WGGGGGGGGGGGGGGGGGGW
WGGGGGGGGGGGGGGGGGGW
WGGGGGGGGGGGSGGGGGGW
WGGGGGGGGGGGGGWWWWWW
WGGGGGGGGGGGGGW
WGGGGGGGGGGGGGW
WGGGGGGGGGGGGGW
WGGGGGGGGGGGGGWWWWWW
WGGGGGGGGGGGGGGGGGGW
WGGGGGGGGWWWGGTGGGGW
WGGBGGGGGWPWGGGGGGGW
WGGGGGGGGWGWGGGGGGGW
WGGGGGGGGGGGGGGGGGGW
WWWWWWWWWWWWWWWWWWWW