WWWWWWWWWWWWWWWWWWWW
WGGGGGGGGGGGGGGGGGGW
WGGGGGGGGGGGGGGGGGGW
WGGGGGGGGGGGGGGGGGGW
WGGGGGGGGGGGGGGGGGGW
WGGHGGGGGGGGGGGGGGGW
WGGGGGGGGGGGGGGGGGGW
WGGGGGGGGGGGGGGGGGGW
WGGGGGGGGGGGGGGGGGGW
WGGGGGGGGGGGGGGGGGGW
WGGGGGGGGGGGGGGGGGGW
WGGGGGGGGGGGGGGGGGGW
WGGGG*GGGGGGGGGGGGGW
WGGGGGGGGGGGGGGGGGGW
WGGGGGGGGGGGGGGGGGGW
WGGGGGGGGGGGGGTGGGGW
WGGGGGGGGGGGGGGGGGGW
WGGGGGGGGGGGGGGGGGGW
WGGGGGGGGGGGGGGGGGGW
WWWWWWWWWWWWWWWWWWWW